1111111111111111111111111111111111111111111111111
1CCCCCCCCCCCCCCCCCCCCCCCCCCCCCCCCCCCCCCCCCCCCCCC1
1CM0000000000000000000000000000000000000000000MC1
1C0111001001110010000000M0000000100111001001110C1
1C010100100101001001000MEM000100100101001001010C1
1C0111001001110010000000M0000000100111001001110C1
1C000000000000000001000000000100000000000000000C1
1C000000000000000000000000000000000000000000000C1
1C011111110010010001011101110100010010011111110C1
1C000000000000010000010000010000010000000000000C1
1C000010000010010001010000010100010010000010000C1
1C000010000000010000010000010000010000000010000C1
1CM0C0000000100000010000C0000100000010000000C0MC1
1C000010000000010000010000010000010000000010000C1
1C000010000010010001010000010100010010000010000C1
1C000000000000010000010000010000010000000000000C1
1C011111110010010001011101110100010010011111110C1
1C000000000000000000000000000000000000000000000C1
1C000000000000000001000000000100000000000000000C1
1C011100100111001000000000000000100111001001110C1
1C0101001001010010010000P0000100100101001001010C1
1C011100100111001000000000000000100111001001110C1
1CM0000000000000000000000000000000000000000000MC1
1CCCCCCCCCCCCCCCCCCCCCCCCCCCCCCCCCCCCCCCCCCCCCCC1
1111111111111111111111111111111111111111111111111