111111111111111111111111111111111111111111111111111
1P000000001110000000001110000C0000111C00000000000C1
1000000000111000000000111000000000111000M0000000001
1000M000000C0000M00000000000M000000C000000000000001
100000000011100000000011100000000011100000000000001
111111000011100000000011100000000011100001111110001
11111100000000000000000C000000000000000001111110001
1C00000000111000000000111000000000111000011111100C1
1000M000001110000M00001110000M000011100000000000001
10000000000C00000000000000000000000C000000000000001
111111000011100000000011100000000011100000000000001
1C00000000111000C000001110000000001110000M0000000E1
111111111111111111111111111111111111111111111111111