1111111111111111
1P000000000000C1
1000000000000001
1000000MC0000001
1C000000000000E1
1111111111111111