11111111111111111111111111111111111111111
1P0000000000000000000000000000000000000C1
1000000M00000000000000M00000000000M000001
10011100000001110000000000111000000000001
10011100000001110000000000111000000000001
10000000M00000C00000M000000000000M00000C1
1000C0000000000000000000000C0000000000001
10011100000001110000000000111000000000001
10011100000001110000000000111000000000001
1C000000M000000000000000000000000000000E1
11111111111111111111111111111111111111111