111111111111111111111
1P00000000000000000C1
100000000100M00000001
1000M0000100000000001
1C000000C1C00000000E1
111111111111111111111