111111111111111111
1P00000C00C00000C1
100000000000000001
100110000000011001
10011000M000011001
100000000000000001
10000000M0000000C1
1C00000000000000E1
111111111111111111