111111111111111111111111
1P0000000C11111C000000C1
100000000011111000M00001
1000M0000011111000000001
100000000010000000000001
1C0000000000000000100001
111111111000001111100001
10000000M000001111100001
1C00000000000011111000E1
111111111111111111111111