11111111111111111111111111111111111
1P0000000C1C0000M000C1C0000000000C1
10000000001000000000010000000000001
10011111001001111110010011111000001
10011111000001111110000011111000M01
10000000001000000000010000000000001
1C00M0000C1C00000000C1C0000000000E1
11111111111111111111111111111111111