111111111111111111111111111111111111111111111
1P00000C111111C0000000000C111111C0000000000C1
100000001111110000M00000001111110000M00000001
100000000000000000000000000000000000000000001
1C0000000000000000000000000000000000000000001
111111110000001111111111110000001111111111111
111111110000001111111111110000001111111111111
1C00000000M00000000C000000000M0000000000000C1
100000000000000000000000000000000000000000001
1000000011111111111100000011111111111100M0001
1000M0001111111111110000M00C11111111110000001
1C00000000000000000000000000000000000000000E1
111111111111111111111111111111111111111111111