111111111111111111111111111
1P00000001C00000000000000C1
10000M00010000M000100000001
1001110000000C0000100000001
1001110000001110000000M0001
100000000000111000000000001
1000000010000C0000100000001
100000001000M00000100000001
1C00000000000000000000000E1
111111111111111111111111111