11111111111111111111111111111111111111111111111111111111111111111
1P0000001111111111111111111111111111111111111111111111110000000C1
10000000111111111111111111111111111111111111111111111111000000001
1000M000111111111111111111111111111111111111111111111111000M00001
1000000000000000000000000000000C000000000000000000000000000000001
10000000000000000000000000000000000000000000000000000000000000001
10000000111110000000001111100000000011111000000000111111000000001
1000000011111000MC00001111100000000011111000M00000111111C00M00001
11111111111110000000001111100000000011111000000000111111111111111
10000000000000000000000000000000000000000000000000000000000000001
10C000000000000000000000000000000000000000000000000000000000000C1
10000000111110000000001111100000000011111000000000111111000000001
1000000011111000MC00001111100000000011111000M00000111111000M00001
10000000111110000000001111100000000011111000000000111111000000001
10000000000000000000000000000000000000000000000000000000000000001
1000000000000000000000000000000C000000000000000000000000000000001
1000M000111111111111111111111111111111111111111111111111000M000C1
1C000000111111111111111111111111111111111111111111111111C000000E1
11111111111111111111111111111111111111111111111111111111111111111