1111111111111111111111111111111111111111111111111111111111111111
1P00000011111111111111111111111111111111111111111111111111111111
1000000011111111111111111111111111111111111111111111111111111111
1000M00011111111111111111111111111111111111111111111111111111111
1000000000000000000011111111111111111111111111111111111111111111
1000000000000000000011111111111111111111111111111111111111111111
1111111111111111000011111111111111111111111111111111111111111111
111111111111111100M011111111111111111111111111111111111111111111
1111111111111111000000000000000000001111111111111111111111111111
1111111111111111000000000000000000001111111111111111111111111111
1111111111111111111111111111111100001111111111111111111111111111
1111111111111111111111111111111100M01111111111111111111111111111
1111111111111111111111111111111100C00000000000000000111111111111
1111111111111111111111111111111100000000000000000000111111111111
1111111111111111111111111111111111111111111111110000111111111111
11111111111111111111111111111111111111111111111100M0111111111111
1111111111111111111111111111111111111111111111110000000000000001
1111111111111111111111111111111111111111111111110000000000000001
11111111111111111111111111111111111111111111111111111111111100C1
1111111111111111111111111111111111111111111111111111111111110001
1111111111111111111111111111111111111111111111111111111111110001
1111111111111111111111111111111111111111111111110000000000000001
1111111111111111111111111111111111111111111111110C00000M00000001
1111111111111111111111111111111111111111111111110000000000000001
11111111111111111111111111111111111111111111111111111111111100C1
1111111111111111111111111111111111111111111111111111111111110001
1111111111111111111111111111111111111111111111111111111111110001
1111111111111111111111111111111111111111111111110000000000000001
1111111111111111111111111111111111111111111111110C0000000M000001
1111111111111111111111111111111111111111111111110000000000000001
11111111111111111111111111111111111111111111111111111111111100C1
1111111111111111111111111111111111111111111111111111111111110001
111111111111111111111111111111111111111111111111C0000000000000E1
1111111111111111111111111111111111111111111111111111111111111111