1111111111111111111111111111111111111111111111111111111111111111111111111111111111111
1111111P00000111111111111111111111111111111111111111111111111111111111111111111111111
1111111000000111111111111111111111111111111111111111111111111111111111111111111111111
1111111000000111111111111111111111111111111111111111111111111111111111111111111111111
1111111000M00000000001111111111111111111111111111111111111111111111111111111111111111
1111111000000000000001111111111111111111111111111111111111111111111111111111111111111
1111111111111111110011111111111111111111111111111111111111111111111111111111111111111
1111111111111111110011111111111111111111111111111111111111111111111111111111111111111
1111111111111111000000111111111111111111111111111111111111111111111111111111111111111
111111111111111100M000111111111111111111111111111111111111111111111111111111111111111
1111111111111111000000111111111111111111111111111111111111111111111111111111111111111
111111111111111100C000000000001111111111111111111111111111111111111111111111111111111
1111111111111111000000000000001111111111111111111111111111111111111111111111111111111
1111111111111111111111111110011111111111111111111111111111111111111111111111111111111
1111111111111111111111111110011111111111111111111111111111111111111111111111111111111
1111111111111111111111110000000011111111111111111111111111111111111111111111111111111
111111111111111111111111000M000011111111111111111111111111111111111111111111111111111
1111111111111111111111110000000011111111111111111111111111111111111111111111111111111
11111111111111111111111100C00C0000000000001111111111111111111111111111111111111111111
1111111111111111111111110000000000000000001111111111111111111111111111111111111111111
1111111111111111111111111111111111111111001111111111111111111111111111111111111111111
1111111111111111111111111111111111111111001111111111111111111111111111111111111111111
1111111111111111111111111111111111000000000000000000111111111111111111111111111111111
11111111111111111111111111111111110000M000000M000000111111111111111111111111111111111
1111111111111111111111111111111111000000000000000000111111111111111111111111111111111
111111111111111111111111111111111100C000C00C000C0000111111111111111111111111111111111
1111111111111111111111111111111111111111111111111100111111111111111111111111111111111
1111111111111111111111111111111111111111111111111100111111111111111111111111111111111
1111111111111111111111111111111111111111000000000000000111111111111111111111111111111
11111111111111111111111111111111111111110000000M0000000111111111111111111111111111111
1111111111111111111111111111111111111111000000000000000111111111111111111111111111111
1111111111111111111111111111111111111111000C000C000C00E111111111111111111111111111111
1111111111111111111111111111111111111111111111111111111111111111111111111111111111111