1111111111111111111111111111111111111111111111111111111111111
1P000000111000000000000000111110000000000000011111000000000M1
1000000011100000000000000011111000000000000001111100000000001
1001111000000111111111110000000001111111000000000000011111001
1001111000000111111111110000M00001111111000000000000011111001
1000000000000000001110000000000001110000000000000000000000001
10000000000000000011100000000000011100000000M0000000000000001
1111111001111110000000001111111111110000001111111111100111111
10000000011111100000000011111111111100000011111111111000000C1
1000000000000000000000000000000000000000000000000000000000001
1000M00000000000000M00000000000000000000000000000000000000001
1001111111110001111111111111000001111111111111000111111111001
1001111111110001111111111111000001111111111111000111111111001
1000000000000000000000000000000000000000000000000000000000001
100000000000000000000000000000M000000000000000000000000000001
1111100111110011111111111000000000001111111111110011111001111
1C00000111110011111111111000000000001111111111110011111000001
1000000000000000000000000000111110000000000000000000000000001
100000000000M00000000000000011111000000000000M000000000000001
1001111111111111110000000000000000000000000000111111111111001
10000000000000000000000000000000000000000000000000000000000E1
1111111111111111111111111111111111111111111111111111111111111