1111111111111111111111111111111111111111111111111111111
1P000000000000010000000000000001000000000000000000000C1
1000000000000001000000000000000100000000000000000000001
100110001100000000001100001100000000110000M000110000001
1001100011000M00000011000011000000001100000000110000001
100000C00000000000000000C0000000000000000C000000000C001
1000000000000000000000000000000000000000000000000000001
1000000000000000M00000000000000M0000000000000000M000001
1001100011000000000011000011000000001100000000110000001
1001100011000000000011000011000000001100000000110000001
10000000000000000000000000000000000000000000000000000C1
10C000M0000C000000M00000C00000000M00000C0000M0000000001
1000000000000000000000000000000000000000000000000000001
10011000110000000000110000110000000011000000001100000E1
1111111111111111111111111111111111111111111111111111111