11111111111111111111111111111111111111111111111
1P0000000000000000000000000000000000000000000C1
10000000000000000000M000M0000000000000000000001
10000000000000000000000000000000000000000000001
10011111111111111111111111111111111111110001001
1001C000000000000000000000000000000000000001001
10010000000000000000M00000000000000000000001001
10010000000000000000000000000000000000000001001
10010011111111111111111111111111111111110001001
1001001C000000000000000000000000000000010001001
1001001000000000M0000E0000M00000000000010001001
10010010000000000000000000000000000000010001001
10010010001111111111111111111111111111110001001
100100000000000000000000000000000000000000M1001
10010000000000000000M00000000000000000000001001
1001C0000000000000000000000000000000000000C1001
10011111111111111111111111111111111111111111001
10000000000000000000000000000000000000000000001
10000000000000000000M000M0000000000000000000001
1C0000000000000000000000000000000000000000000C1
11111111111111111111111111111111111111111111111