1111111111111111111111111111111111111111111111111111111111111111111111111111111111111111111
1P00000000000000000000000000000000000000000000000000000000000000000000000000000000000000001
1010101010101010101010101010101010101010101010101010101010101010101010101010101010101010101
1000000000000000000000000000000000000000000000000000000000000000000000000000000000000000001
1010101010101010101010101010101010101010101010101010101010101010101010101010101010101010101
1000000000000000000000000000000000000000000000000000000000000000000000000000000000000000001
1010101010101010101010101010101010101010101010101010101010101010101010101010101010101010101
1000000000000000000000000000000000000000000000000000000000000000000000000000000000000000001
1010101010101010101010101010101010101010101010101010101010101010101010101010101010101010101
100000C000000000000000000000000000000000000000000000000000000000000000000000000000000000001
1010101010101010101010101010101010101010101010101010101010101010101010101010101010101010101
100000000000000000000000000000000000000000M000000000000000000000000000000000000000000000001
1010101010101010101010101010101010101010101010101010101010101010101010101010101010101010101
1000000000000000000000000000000000000000000000000000000000000000000000000000000000000000001
1010101010101010101010101010101010101010101010101010101010101010101010101010101010101010101
1000000000000000000000000000000000000000000000000000000000000000000000000000000000000000001
1010101010101010101010101010101010101010101010101010101010101010101010101010101010101010101
10000000000000000000000000000000000000000000000000000000000000000000000000000000000000000C1
1010101010101010101010101010101010101010101010101010101010101010101010101010101010101010101
1000000000000000000000000000000000000000000000000000000000000000000000000000000000000000001
1010101010101010101010101010101010101010101010101010101010101010101010101010101010101010101
1000000000000000000000M00000000000000000000000000000000000000000000000000000000000000000001
1010101010101010101010101010101010101010101010101010101010101010101010101010101010101010101
1000000000000000000000000000000000000000000000000000000000000000000000000000000000000000001
1010101010101010101010101010101010101010101010101010101010101010101010101010101010101010101
1000000000000000000000000000000000000000000000000000000000000000000000000000000000000000001
1010101010101010101010101010101010101010101010101010101010101010101010101010101010101010101
1000000000000000000000000000000000000M00000000000000000000000000000000000000000000000000001
1010101010101010101010101010101010101010101010101010101010101010101010101010101010101010101
1000000000000000000000000000000000000000000000000000000000000000000000000000000000000000001
1010101010101010101010101010101010101010101010101010101010101010101010101010101010101010101
1000000000000000000000000000000000000000000000000000000000000000000000000000000000000000001
1010101010101010101010101010101010101010101010101010101010101010101010101010101010101010101
100000000000000000000000000000000000000000000000000000000000000000000000000000000M000000001
1010101010101010101010101010101010101010101010101010101010101010101010101010101010101010101
100000C000000000000000000000000000000000000000000000000000000000000000000000000000000000001
1010101010101010101010101010101010101010101010101010101010101010101010101010101010101010101
1000000000000000000000000000000000000M00000000000000000000000000000000000000000000000000001
1010101010101010101010101010101010101010101010101010101010101010101010101010101010101010101
10000000000000000000C0000000000000000000000000000000000000M000000000000000000000000000000E1
1111111111111111111111111111111111111111111111111111111111111111111111111111111111111111111