111111111111111111111111111111111111111111111111111
1P00000000011111111111110000C00001111111111110000C1
100000000001111111111111000000000111111111111000001
10000M0000011111111111110000M0000111111111111000001
10000000000000000011111100000000000000011111100M001
10C0000000000000001111110C0000000000000111111000001
100000000001111111111111110000011111111111111000001
100000000001111111111111000000000111111111111000001
1000000000011111111111110000000001111111111110000C1
111100111111111111111111000000000111111111111000001
10000C0000011111111111110000M0000111111111111000001
10000000000000000000000000000000000000000000000M001
10000M0000000000000000000000000000000000000000000E1
111111111111111111111111111111111111111111111111111