111111111111111111111
1P00000000100000000C1
101110111010111011101
101000001000100000101
101011101111101110101
10001C0000M0000C10001
101110111011101111101
1000001C001E000000MC1
111111111111111111111