11111111111111111111111111111111111111111
1P0000001000001111100000100000111110000C1
10000000100000000010000010000000001000001
1001110000000010C010000000000010C01000001
1001110000M0001011100000000M0011101000001
10011100000000000000000000000000000000001
10000000000000000000000000000000000000001
10000000111110000011101110000011111000001
100C00000000100000100C0010000000001000001
100000001000100M000000000000001000100M001
10000000100000000010000010000010001000001
1000M0001111100000111011100000111010000C1
10000000000000000000000000000000000000001
1000000000000000M0000000000M0000000000001
100111000000001011100000000000111010000C1
10011100000000100000000000000010001000001
1C01110000M00010C0100000M0000000C01000001
100000000000001111100000000000111110000E1
11111111111111111111111111111111111111111