11111111111111111111111111111111111111111111111111111111111111111
1P0000000000000000010000000000000000000100000000000000000C0000001
10000000000000000001000000M00000000000010000000000000000000000001
100110000001100000000000000000000000000000000000110000001100000C1
10011000C0011000000000M00000C00000M000000000000011000000110000001
10000000000000000000000000000000000000000000000000000000000000001
100000000000000000000000000000000000000000000000000000000000M0001
1C0000M000000000011111000000000000000111110000000000M000000000001
100000000000000001000100000000000000010001000000000000000000000C1
1000000000000000010C0100000M00000000010C0100000000000000000000001
10000000000000000000000000000000000000000000000000000000000000001
1C0011000000000000000000000000000000000000000000000000000011000C1
10001100000000000000000000000000000000000000000000000000001100001
100000000000000000000000M0000000C00000000000000000000M00000000001
100000000M0000000000000000000000000000000000000000000000000000001
1C0000000000000000000000000000000000000000000000000000000000000E1
11111111111111111111111111111111111111111111111111111111111111111