111111111111111111111111111111111111111111111111111111111111111111111
1P00000000000111111111111111110000000000011111111111111111000000000C1
100000C0000001111111111111111100000C000001111111111111111100C00000001
10000M0000000111111111111111110000M000000111111111111111110000M000001
100000000000011111111111111111000000000001111111111111111100000000001
111110001111111111111111111111111110001111111111111111111111111000111
111110001111111111111111111111111110001111111111111111111111111000111
111110001111111111111111111111111110001111111111111111111111111000111
111110001111111111111111111111111110001111111111111111111111111000111
100000000000000000000000000000000000000000000000000000000000000000001
10C0000000C0000000C0000000M0000000C0000000M0000000C0000000C0000000C01
100000000000000000000000000000000000000000000000000000000000000000001
111110001111111111111111111111111110001111111111111111111111111000111
111110001111111111111111111111111110001111111111111111111111111000111
111110001111111111111111111111111110001111111111111111111111111000111
111110001111111111111111111111111110001111111111111111111111111000111
100000000000011111111111111111000000000001111111111111111100000000001
100000000000011111111111111111000000000001111111111111111100000000001
10000MC000000111111111111111110000MC000001111111111111111100C00000001
1000000000000111111111111111110000000000011111111111111111000000000E1
111111111111111111111111111111111111111111111111111111111111111111111