NO texture/backroom_wall.xpm
SO texture/backroom_wall.xpm
WE texture/backroom_wall.xpm
EA texture/backroom_wall.xpm
D texture/jp_wall1.xpm

F 0, 0, 0
C 0, 0, 120


                                                                                                                     111111111
                                                                                                                     100000001
                                                                                                                     100000001
            111111111111111111111111111111111111111111111111111111111111111111111111111111111111111111111111111111111100000001111111111111111111111
            1000D0000000000000000000000000000000000000000000000000000000000000000000000000000000000000000000000000000000000000000000000000000000001
      111111101111111101111111110111111111111111111111111111111111111111111111111111111111111110000000011111111111111100000001111111111111110000001
      10000000000000000000000000000000000000000000000000000000000000000000000000000000000000000000000001             100000001             10000001
      100000000000000000000000000000000000000000000000000000000000000000000000000000000000000000000000011111111111111100000001             10000001
      100000000111111101111111110000000000111111111111111111111111111111100000000000000000000000000000000000000000001100000001             10000001
      1000000001     101     1110000000000111111111111111111111111111111100000000011111111100000000000011000000000001100000001             10000001
      1000000001    1101111111000000000000000000000000000000000000000000000000000000000111100000000000011000000000001100000001             10000001
      1000000001    10000000000000000000000000000000000000000000000000000000000000000000000000000000000000000000000000000000011111111111   10000001
      1111111001111110000000000000000000000000000000000000000000000000000000000000000000000000000000000000000000000000000000000000000001   10111111
            1000000000000000000000000000000000000000000000000000000000000000000000000000000000000000000000000000000000000000000000000001   101
            1000000000000001110100000000001111111111111111111100000000000000000000000000011011101111111110000000000011000000000000000001   101
            1000000000000001 1D100000000001                  10011110000000000000000000001101 101       10000000000011011110000000000001   101
            1000000000000001 10101111111111                  1001  10000000000000000000001101 101       1011111111111101  10000000000001   101
            1000000000000001 10101   111111111111111111111111100111100000000111000000000011011101111111110111111111111D11110001110111111   101
            100000000000000111010111110000000000000000000000000000000000000000000000000000000000D0000000000000000000000000000001101        101
            10111111100000000000000000000000000000000000000000000000000000000000000000000110111011111111000001111110000000000001101        101
            101     1000000111010111110111111111111111111111110011110000000011101D10000001101 1D1      1000001    10000000000001101        101
            101     10000001 10101   101                     1001  10000000000001010000001101 101      1000001    10000000000001101        101
            101     10000001 10101   101111111111111111111111100111100000000001010100000011011101111111100000111111000000000000110111      101
            101     10010011 10101   101000000000000000000000000000000000000000000000000000000000000000000000000000000000000000000001      101
            101     1001001  10101   101011101111111111111111100111101111000001010100000011011101000000000000111111000000000000000001      101
    111111111D11111110010011110101111101011101111111         100111101111000001010100000011011101000000000000111111000000000000000001      101
    100D00000000000000000000000000000000000000000001         100000000000000000000000000000000000000000000000000000000000000000000001      101
    101111110000000000000000000000000000000000000001         1000000011110000010101000000110111010000000000001111110000000000000000011111111011111111
    101    10000000000000011110101111100000000000001         100000001  101111101010000001101 1010000000001111    11110111100000000000000000000000001
    101    1000000000000001111010111110000000000000111111111110000000111101111101D1101111110111010000000001111111111110111100000000001111000000000001
    101    1000000000000000000000D0000000000000000000000000000000000000000000000000000D0000000D000000000000000000000000001100000000001  1000000000001
    101    100000000000000111101011111000000000000011111111111000000011110111110101101111110111010111111001111111111110101100000000001111000000000001
    101    100000000000000000000000000000000000000000000000000000000000000000000000000000D000D0000000000000000000000000000000000000000001000000000001
    1D1    100000000000000N00000000011000000000111111111111111000000011110111110101101111110111010111111001111111111110101100000000001101000000000001
    101    100000000000000000000000000000000000000000000000000000000000000000000000000000000000000111111001111111111110101100011101101101000000000001
    101    10000000000000000000000001100000000011111111111111100011101111011111010100000000000000000000000000000D00000000000001 1011011D1000000000001
    101    1000000000000000000000000110000000001             10001 101  101   1010100000000001101011111100111111111111010110001 101101101000000000001
    101    100000000000000000000000011000000000111111111111111000111011110111110101000000000011010111111001111111111110101100011101101101000000000001
    101    1000000000000000000000000000000000000000000D00000000000000000000000D00000000000000000000000000000000D0000000000000000101101101000000000001
    101    100110000000000000000000011000111011111111111111111000111011110111110101000000000011010111111001111111111110101100000101101101011011111111
    101    1001100000000000000000000000000000000000000000000000000000000000000000000000000000000000000000001     10000000000000000110110101101
    101    10011000000000011010101111100011101111111111111111100011101111011111010100000000001101010000000011111110111000000000000110110101101
    101    10011000000000011010101   10001 101   100000000000000000000000000000000000000000000000000000000000000000000000000000000000000000001
    101    10011000000000011010101   10001 1D1   10111111111110001110111101111101010011111101110101000000001111111D111000000000000000000000001
    101    10011001110000011010101   10001 101   101         10001 101  101   10101001    101 101010000000011111110111000000000000000000000001
    101    10011001 1000001101D101   10001 1D1   101         10001 101  101   10101001    101 101010000000000000000011000000000000000000000001
    101    10011001 10000011010101   10001 101   101         10001 101  101   10101001    101 101010000000000000000011000000000000000000000001
    101    10011001 10000011010101   10001 101   101   11111110001110111101111101010011111101 101010000000000000000011000000000000000000000001
    101    10011001 10000011010101   10001 101   101   10000000000000000000000000000000000101 101010000000000000000011000000000000000000000001
    101    10011001 10000011010101111100011101111101111100000000000101111011111010100111101D11101010111100100000000011000000000000000000000001
    101    10011001 1000001101000000000000D00D000000000000000000000000000000000000000000000000000000000000100000000011000000000000110000000001
    1D1    10011001 10000011010001111100011101111101111100000000000000011011111010100111101011101000000000100000000011000000000000110000000001
    101    10011001 10000011010000000000000D01   101111000000000000000000000000000000000000000000000000000000000000000000000001110110000000001
    101    10011001 10000011D10000000000011101   100000000000000000000000000000000000000000000000000000000100000000011000110001 10110000000001
    101    10011001 10000011D1000000000001 101   100000000000000000000011011111010100111101011100000000000100000000011000110001 10110010101101
    101    10011001 1000001101000000000001110111110000000000000000000001101   10101001  1D101 100000000000100000000000000000001 1011001D101101
    101    10011001 1000001101000000000000000000000000000000000000000011101   10101001  10101 100000111100101111110100000000001 10110010101101
    101    10011001 100000110110011111000111011111000000000011000000001 101   10101001  10101 1000001  100101    10100000000001 1D110010101101
    101    10011001 10000011011001   10001 101   1000000000011000000001 101   10101001  10101 1000001  100101    10100000000001 10110010101101
    101    10011001 10000011011001   10001 101   1000000000011000000001 101   10101001  10101 1000001  100101    1D100000000001 10110010101101
    101    10011001 10000011011001   10001 101   1000000000011000000001 101   10101001  10101 1000001  100101    10100000000001 10110010101101
    101    100110011100000110110011111000111011111000000000011000000001110111110101001111010111000001  100101    10100000000001 10110010101101
    101111110000000000000000000000000000000000000000000000000000000000000000000000000000000000000000111100101111110100000000001 10110010101101
    1000000000000000000000110110000000000000000000000000000000000000000000000000000000000000000000000DD000000000000100000000001 10110010101101
    100000000000000000000011011000001100011101111101111001111100000000111011111010000000000000000010111100101111100100000000001 10110010101101
    100000000000000000000011011000001100011101111101111001111100000000111D111110100000001010111000101  100101   100100000000001 10110010101101
    1000000000000000000000000000000000000000000000000000000D00000000000000DD00000000000010101 1000101  100101   100100000000001 10110010101101
    10000000000000000000000000000000110001110111110111100111110001110111101111101000000010101 1000101  100101   100100000110001 1011001D101101
    100000000000000000000000000000000000000000000000000000000000000001111011111010000000101011100010111100101111100100000110001110110010101101
    100000000000000000000000000000000000000000000000000000000000000000000000000000000000000000000000000000000000000000000000000000000000000001
    100000000000000000000000000000011100011101111101111101111100011111111011111011101111101011100010111100101111100100000110001110110010101111
    10000000000000000000000000000000000000000000D000000D000000000000000000000000000001  10101 1000101  100101   100100000110001 10110010101
    1000000000000000000000000000000111000111011111011111011111000111111110111110000001  10101 10001D1  100101   100100000110001 10110010101
    10000000000000000000000000000001 10001 101   101   1011111000111111110111110000001  10101 1000101  100101   100100000110001 10110010101
    10011111101100011000000000000001 10001 101   101   1000000000000000000000000000001  1D101 1000101  100101   100100000110001 10110010101
    1001    101100011000000000000111 100011101111101111100000000011111111011111000000111101011100010111100101111100100000110001 10110010101
    1001    1D11000110000000000001   10000D00000000000D000000000000000000000000000000000D00000000000000000000000000000000110001 10110010101
    1001    1011000110000000000001   1000111011111011111000000000111111110100000000001111010111000000000001011111001001001100011101100101D1
    1001    1011000110000000000001   10001 101   101   10000000001      1010000000000111101011100000000000101   100100100110000000000000001
    1001    1011000110000000000001   10001 101   101   10000000001      10100000000000000000D0000000000000101   100100100110000000000000111
    1001  111011000110110011011101111100011101   101   10000000001      10100000000000011010111000000000001011111000000000000000000000001111111
    1001  1000000000000000000000000000000000011111011111011111000111111110100000000000000000000000000000000000000000000000000000000000000000001
    1001  10100000000000000000000000000000000000000000000000D0000D00000000000000000000000000000000000000000000000000000000000000000000000000001
    1001111010110001111100110111000000000000011111011111011111000111111110100000000000011010111000001111001011111000000000000010000000100000001
    1000000000000000000000000000000000000000000000000000000000000000000000000000000000000000000000000011001D11111000000000000010000000100000001
    1011111010110001111100110111000000000000011111011111011111000111111110100110111101111000000000000000000000000000000000000010000000100000001
    10111110101100011111001101110000000000000111110111110111110001111111100000000000000000000000000000000010111110000000000000100000001000000011
    10000000000000000D0000000000000000000000000DD00000000000000000000000000000000000000000000000000000000000000000000000000000000000000000000001
    1000001010110001111100110111000000000000011111D111110111110000000000000000000000000000000000000000000010111110000000000000101011001000000001
    10000010101100000000000000000000000000000000000000000000000000000000000000000000000000000000000000000000000000000000000000000000001000000001
    10000000000000000000000000000000000000000000000000000000000000000000000000000000000000000000000000000000000000000000000000000000001111111101
    10000000000000011111001101110111110011110111110111110111110111111111111001100000000000000000000000000000000000000000000000000000001      101
    10000000000000000000000000000000000000000000000000000000000000000000000000000000000000000000000000000000000000000000000000000000001      101
    10000000000000011111001101110111110011110111110111110111110111111111111001100000000000001110000000000000000111010000000000000000001      101
    1000000000000001   1001101 10000000000000000D000000000D000000D00000000000000000000000000D0000000000000000001 1010000000000000000001      101
    1000001010010001   10011D1 1011111001111011111011111011111011111111111100110000000000000111000000000000000011101000000000000000000111111110111111
    1000001010010001   100110111011111001111011111011111011111011111111111100000000000000000000000000000000000000000000000000000000000000000000000001
    1000001010010001   1001100000000000000000000000000D0000000000D00000000000000000000000000000000000000000000000000000000000000000000000000000000001
    1000001010010001   100110111011111001111011111011111011111011111111111110000000000001110111000001000000011111100000000000000000000000000000000001
    1011111010010001   1001101 101   1001  101   101   101   1D1           10000000000001 101 100000100000001    100000000000000000000000000000000001
    101   1010010001   1001101 101   1001  10111110111110111110111111111111100000000000011101 100000100100101    100000001000000100000000000000000001
    101   1D10010001   1001101 101   1001  10D00000000000000000000000000000000000000000000001 100000100100101    100000001000000100000000000000000001
    101   1010010001   1001101 101   1001  10111110111110111110111111111111100101111000000001 100000100100101    100000001000000100000000000000000001
    101   1D10010001   1001101 101   1001  1011111011111011111011111111111110010111100000000111000001001001011111100000001000000100000000000000000001
    101   1D10010001   1001101 101   1001  10000000000000000000000000000000D0000D00000000000000000000000000000000000000000000000000000000000010111111
    101   10100100011111001101110111110011110000000111110111110111111111111100101111000000001110000010010010111111110110110100101011001111111101
    101   10100000000000000000000000000000000000000000000000000000000000000000000000000000001 100000100100101      10110110100101011001      101
    101   10100000000000000000000001110011110000000111110111110111111111111100111111111011101 100000100100101      10100000000000011001      1D1
    101   10100000000000000000000001 1001  100000001   101   101           100111111111011101110000010010010111111110100110000000011001      101
    101   10100000000000000000000001 1001  100000001   101   101           100000000000000000000000000000000000000000000000000000011001      101
    101   10100000000000000000000001 1001  100000001   101   101           10000000000000010111000000000001011111111D100000000000011001      101
    101   10100000000000000000000001110011110000000111110111110111111111111100000000000000101 10000000000010111111110100000000000011001      101
    1D1   10100000000000001101110000000000000000000000000000000000000000000000000000000000101 1000000000000000D000000100000000000011001      101
    101   10100100000000000000000000000000000000000111110111110111111111111100000000000000101 10000000000000111111111100000000000011001      101
    101   101001000011110011011101111100000000000001111101111101111111111111000000000000001011100000000000001        100000000000011001      101
    101   1010000000000000000000000D0000000000000000D00000000000000000000000000000000000000000000000000000001        110110000000011001      101
    101   10110000000000000000000011110000000000000111110111110111111111111100000000000000101110000000000000111111111110110100101011001      101
    10111110110000000000000000000011110000000000000000000000000000000000000000000000000000000000000000000000000000000000000000101011001111111101
    10000000000000000000000000000000000000000000000000000000000000000000000000000000000000000000000000000000000000000000000000000000000000001101
    111111100000000000000000000000000000000000000000000000000000000000000000000000000000000000000000000000000000000000000000000000000000000011011111
          100000000000000000000000000000000000000000000000000000000000000000000000000000000000000000000000000000000000000000000000000000000000000001
          100000000000001011000000000000000000000000000000000000000000000000000000000000000000000000000000000000000000000000001010000000000011000001
          100000000000001011000000000000000000000001111111111101111111111111000000011110111011101100000000001111111000000000001010000000000011000001
          100000000000001011000000000000000000000001         101           100000001  1D1 101 101100000000001     1000000000001010000000000011000001
          100000000000001011000000000000000000000001         101           110011111  101 101 101100011110111     1000000000001010000000000011000001
          100000000000001011000000000000000000000001         101            1001      101 101 101100011110111111111000000000001010000000000011000001
          100000000001111011000000000000000000000001         101            1001      101 101 101100000000000000000000000001000000000000011111000001
          100000000001  1011000000011110000000000001         101            1001      101 101 1D110000000000111111101111111100000001000001   1111111
          100000001011  101101111111  10000000000001111111111101111111111111100111111110111011101100000000001     101      100000001111111
          11111111101   101101        1111110000000000000000D000000000000000000000000000000000101100000000001     101      100000001
                  101   101101             100000000001111111101111111111111100111111110111000000000000000001     101      100000001
                  10111110110111111111111111000000000011111111011111111111111001      101 100000000000000000111111101111111100000001
                  100000000D0000000000000000000000000000000000000000000000000001111111101110000000000000000000000000000000D000000001
                  100000001100000000000000000000000000000000000000000000000000000000D00000000000000011111000000000001111111100000001
                  100000001100000000111111110000000000111111110111111111111111011111111011100000000011111000000000001111111110111011
                  1000000000000000000000000000000000000D00000000000000000000000000000000000000000000000000000000000000000000001 101
                  10000000000000000011111111000000000011111111D111111111111111011111111000000000000000000000000000001111111111111011111111
                  1000000000000000001      100000000001      101             100000000000000000000000000000000000000000D0000D0000000000001
                  1111111000000000001      100000000001111111101             1111111111000000000000000000111111111111111111111111000000001
                        1000000011111      100000000000000000001                      10000000000000000001                      1000000001
                        100000001          111111100000011111111                      10000000000000000001                      1000000001
                        111111111                10000001                             10000000000000000001                      1000000001
                                                 10000001                             10000000000000000001                      1000000001
                                                 10000001                             11111111111111111111                      1000000001
                                                 11111111                                                                       1000000001
                                                                                                                                1000000001
                                                                                                                                1111111111


