NO texture/jp_wall4.xpm
SO texture/jp_wall5.xpm
WE texture/jp_wall2.xpm
EA texture/jp_wall3.xpm
D texture/jp_wall1.xpm

F 50,50,50
C 100,100,100

1111111111111111111111111
1000000000110000000000001
1011111110110111111111101
1010000010000100000000101
1010000010000100000000101
1010000011001100000000101
1011101111001111101111101
1000000000000000000000001
1111111111001111111111111
1000000001001000000000001
100000000D000000000000001
100000000100100000N000001
1111111111111111111111111