NO texture/jp_wall4.xpm
SO texture/jp_wall5.xpm
WE texture/jp_wall2.xpm
EA texture/jp_wall3.xpm

F 0,0,0
C 0,0,120

        1111111111111111111111111
        1000000000110000000000001
        1011000001110000000000001
        1001000000000000000000001
111111111011000001110000000000001
10000000001100000111011111D111111
11110111111111011100000010001
11110111111111011101010010001
11000000110101011100000010001
100S0000000000001100000010001
1000000000000001101010010001
1100000111010101111101111000111
1111D111 1110111 111111010001
100001   11111 1 1  111000111
100001               100001
100001               100001
100001               100001
1000011111111111111111000011111
1000000000000000000000000000001
1000000000000000000000000000001
1000000001000000000000000000001
1000000111111111111111111111111
10000001
10000001
10000001
10000001
10000001
10000001
10000001
10000001
10000001
11111111

